Date,Sector,Market Moves,New Trades,Fees,Total
1/3/2011,Consumer Discretionary,-3950,-1975,0,-5925
1/3/2011,Consumer Staples,-2100,-1050,0,-3150
1/3/2011,Energy,-2000,-1000,0,-3000
1/3/2011,Financials,-3900,-1950,0,-5850
1/3/2011,Health Care,-2600,-1300,0,-3900
1/3/2011,Industrials,-2950,-1475,0,-4425
1/3/2011,Information Technology,-3800,-1900,0,-5700
1/3/2011,Materials,-1550,-775,0,-2325
1/3/2011,Telecommunication Services,-450,-225,0,-675
1/3/2011,Utilities,-1700,-850,0,-2550
1/4/2011,Consumer Discretionary,-3303,-1779,-107,-5189
1/4/2011,Consumer Staples,-1682,-930,-58,-2670
1/4/2011,Energy,-1668,-894,-45,-2607
1/4/2011,Financials,-3200,-1732,-110,-5042
1/4/2011,Health Care,-2159,-1165,-90,-3414
1/4/2011,Industrials,-2441,-1302,-68,-3811
1/4/2011,Information Technology,-3174,-1708,-80,-4962
1/4/2011,Materials,-1329,-704,-31,-2064
1/4/2011,Telecommunication Services,-351,-196,-11,-558
1/4/2011,Utilities,-1422,-757,-38,-2217
1/5/2011,Consumer Discretionary,-2753,-1606,-161,-4520
1/5/2011,Consumer Staples,-1349,-836,-113,-2298
1/5/2011,Energy,-1367,-814,-83,-2264
1/5/2011,Financials,-2637,-1588,-202,-4427
1/5/2011,Health Care,-1819,-1068,-130,-3017
1/5/2011,Industrials,-2007,-1169,-104,-3280
1/5/2011,Information Technology,-2631,-1539,-144,-4314
1/5/2011,Materials,-1106,-652,-54,-1812
1/5/2011,Telecommunication Services,-270,-178,-19,-467
1/5/2011,Utilities,-1191,-679,-47,-1917
1/6/2011,Consumer Discretionary,-2304,-1499,-195,-3998
1/6/2011,Consumer Staples,-1053,-748,-129,-1930
1/6/2011,Energy,-1122,-753,-131,-2006
1/6/2011,Financials,-2204,-1446,-253,-3903
1/6/2011,Health Care,-1509,-981,-177,-2667
1/6/2011,Industrials,-1636,-1069,-164,-2869
1/6/2011,Information Technology,-2171,-1421,-204,-3796
1/6/2011,Materials,-955,-612,-76,-1643
1/6/2011,Telecommunication Services,-203,-152,-37,-392
1/6/2011,Utilities,-1011,-634,-94,-1739
1/7/2011,Consumer Discretionary,-1898,-1366,-253,-3517
1/7/2011,Consumer Staples,-808,-674,-147,-1629
1/7/2011,Energy,-891,-680,-141,-1712
1/7/2011,Financials,-1796,-1319,-265,-3380
1/7/2011,Health Care,-1245,-890,-175,-2310
1/7/2011,Industrials,-1340,-1000,-180,-2520
1/7/2011,Information Technology,-1821,-1307,-234,-3362
1/7/2011,Materials,-805,-568,-90,-1463
1/7/2011,Telecommunication Services,-141,-145,-39,-325
1/7/2011,Utilities,-838,-592,-101,-1531
1/10/2011,Consumer Discretionary,-1575,-1257,-283,-3115
1/10/2011,Consumer Staples,-591,-633,-170,-1394
1/10/2011,Energy,-734,-638,-145,-1517
1/10/2011,Financials,-1445,-1240,-317,-3002
1/10/2011,Health Care,-999,-831,-190,-2020
1/10/2011,Industrials,-1096,-949,-198,-2243
1/10/2011,Information Technology,-1513,-1235,-265,-3013
1/10/2011,Materials,-702,-547,-85,-1334
1/10/2011,Telecommunication Services,-91,-121,-42,-254
1/10/2011,Utilities,-690,-550,-124,-1364
1/11/2011,Consumer Discretionary,-1266,-1165,-292,-2723
1/11/2011,Consumer Staples,-404,-592,-187,-1183
1/11/2011,Energy,-583,-583,-157,-1323
1/11/2011,Financials,-1151,-1174,-321,-2646
1/11/2011,Health Care,-814,-795,-217,-1826
1/11/2011,Industrials,-869,-884,-232,-1985
1/11/2011,Information Technology,-1188,-1140,-294,-2622
1/11/2011,Materials,-588,-535,-98,-1221
1/11/2011,Telecommunication Services,-40,-119,-51,-210
1/11/2011,Utilities,-576,-512,-119,-1207
1/12/2011,Consumer Discretionary,-1048,-1159,-330,-2537
1/12/2011,Consumer Staples,-265,-543,-197,-1005
1/12/2011,Energy,-456,-545,-167,-1168
1/12/2011,Financials,-856,-1132,-337,-2325
1/12/2011,Health Care,-662,-757,-223,-1642
1/12/2011,Industrials,-679,-858,-292,-1829
1/12/2011,Information Technology,-937,-1062,-314,-2313
1/12/2011,Materials,-492,-488,-110,-1090
1/12/2011,Telecommunication Services,-5,-115,-51,-171
1/12/2011,Utilities,-461,-468,-123,-1052
1/13/2011,Consumer Discretionary,-861,-1063,-322,-2246
1/13/2011,Consumer Staples,-101,-528,-218,-847
1/13/2011,Energy,-357,-500,-168,-1025
1/13/2011,Financials,-601,-1053,-372,-2026
1/13/2011,Health Care,-534,-705,-242,-1481
1/13/2011,Industrials,-492,-817,-296,-1605
1/13/2011,Information Technology,-710,-985,-349,-2044
1/13/2011,Materials,-404,-473,-113,-990
1/13/2011,Telecommunication Services,19,-107,-40,-128
1/13/2011,Utilities,-378,-431,-128,-937
1/14/2011,Consumer Discretionary,-636,-992,-373,-2001
1/14/2011,Consumer Staples,31,-488,-225,-682
1/14/2011,Energy,-256,-470,-182,-908
1/14/2011,Financials,-350,-987,-383,-1720
1/14/2011,Health Care,-386,-685,-262,-1333
1/14/2011,Industrials,-337,-757,-300,-1394
1/14/2011,Information Technology,-474,-904,-409,-1787
1/14/2011,Materials,-305,-456,-123,-884
1/14/2011,Telecommunication Services,51,-105,-56,-110
1/14/2011,Utilities,-284,-392,-157,-833
1/17/2011,Consumer Discretionary,-439,-922,-382,-1743
1/17/2011,Consumer Staples,125,-453,-236,-564
1/17/2011,Energy,-152,-440,-197,-789
1/17/2011,Financials,-180,-925,-414,-1519
1/17/2011,Health Care,-262,-663,-267,-1192
1/17/2011,Industrials,-172,-724,-309,-1205
1/17/2011,Information Technology,-305,-850,-425,-1580
1/17/2011,Materials,-210,-432,-121,-763
1/17/2011,Telecommunication Services,83,-119,-56,-92
1/17/2011,Utilities,-217,-350,-164,-731
1/18/2011,Consumer Discretionary,-270,-848,-404,-1522
1/18/2011,Consumer Staples,234,-412,-268,-446
1/18/2011,Energy,-52,-407,-188,-647
1/18/2011,Financials,4,-861,-429,-1286
1/18/2011,Health Care,-157,-612,-283,-1052
1/18/2011,Industrials,-21,-666,-323,-1010
1/18/2011,Information Technology,-166,-827,-416,-1409
1/18/2011,Materials,-146,-425,-128,-699
1/18/2011,Telecommunication Services,105,-114,-48,-57
1/18/2011,Utilities,-147,-339,-191,-677
1/19/2011,Consumer Discretionary,-122,-798,-403,-1323
1/19/2011,Consumer Staples,358,-354,-275,-271
1/19/2011,Energy,48,-391,-187,-530
1/19/2011,Financials,230,-779,-446,-995
1/19/2011,Health Care,-9,-604,-324,-937
1/19/2011,Industrials,154,-635,-358,-839
1/19/2011,Information Technology,5,-787,-467,-1249
1/19/2011,Materials,-98,-373,-154,-625
1/19/2011,Telecommunication Services,129,-105,-61,-37
1/19/2011,Utilities,-80,-313,-187,-580
1/20/2011,Consumer Discretionary,74,-764,-427,-1117
1/20/2011,Consumer Staples,437,-345,-274,-182
1/20/2011,Energy,136,-362,-217,-443
1/20/2011,Financials,439,-744,-455,-760
1/20/2011,Health Care,102,-544,-327,-769
1/20/2011,Industrials,271,-616,-361,-706
1/20/2011,Information Technology,190,-748,-478,-1036
1/20/2011,Materials,-27,-357,-175,-559
1/20/2011,Telecommunication Services,170,-94,-61,15
1/20/2011,Utilities,-9,-295,-189,-493
1/21/2011,Consumer Discretionary,230,-707,-465,-942
1/21/2011,Consumer Staples,536,-341,-278,-83
1/21/2011,Energy,223,-326,-223,-326
1/21/2011,Financials,612,-696,-461,-545
1/21/2011,Health Care,193,-521,-320,-648
1/21/2011,Industrials,388,-574,-377,-563
1/21/2011,Information Technology,335,-723,-472,-860
1/21/2011,Materials,32,-343,-179,-490
1/21/2011,Telecommunication Services,188,-97,-49,42
1/21/2011,Utilities,50,-285,-199,-434
1/24/2011,Consumer Discretionary,384,-648,-494,-758
1/24/2011,Consumer Staples,658,-285,-300,73
1/24/2011,Energy,313,-312,-222,-221
1/24/2011,Financials,773,-631,-518,-376
1/24/2011,Health Care,322,-450,-325,-453
1/24/2011,Industrials,508,-545,-406,-443
1/24/2011,Information Technology,492,-655,-493,-656
1/24/2011,Materials,83,-348,-202,-467
1/24/2011,Telecommunication Services,222,-93,-55,74
1/24/2011,Utilities,110,-261,-185,-336
1/25/2011,Consumer Discretionary,553,-591,-506,-544
1/25/2011,Consumer Staples,754,-264,-313,177
1/25/2011,Energy,419,-296,-238,-115
1/25/2011,Financials,963,-560,-518,-115
1/25/2011,Health Care,445,-430,-352,-337
1/25/2011,Industrials,662,-514,-396,-248
1/25/2011,Information Technology,632,-603,-529,-500
1/25/2011,Materials,134,-339,-216,-421
1/25/2011,Telecommunication Services,237,-82,-60,95
1/25/2011,Utilities,208,-239,-196,-227
1/26/2011,Consumer Discretionary,750,-555,-538,-343
1/26/2011,Consumer Staples,874,-280,-298,296
1/26/2011,Energy,523,-231,-280,12
1/26/2011,Financials,1104,-497,-559,48
1/26/2011,Health Care,541,-409,-356,-224
1/26/2011,Industrials,785,-465,-411,-91
1/26/2011,Information Technology,803,-549,-546,-292
1/26/2011,Materials,165,-310,-210,-355
1/26/2011,Telecommunication Services,261,-69,-63,129
1/26/2011,Utilities,254,-200,-212,-158
1/27/2011,Consumer Discretionary,893,-504,-542,-153
1/27/2011,Consumer Staples,1004,-249,-304,451
1/27/2011,Energy,565,-193,-305,67
1/27/2011,Financials,1293,-425,-583,285
1/27/2011,Health Care,646,-348,-398,-100
1/27/2011,Industrials,902,-430,-441,31
1/27/2011,Information Technology,967,-529,-574,-136
1/27/2011,Materials,255,-291,-205,-241
1/27/2011,Telecommunication Services,287,-55,-72,160
1/27/2011,Utilities,321,-196,-211,-86
1/28/2011,Consumer Discretionary,1098,-493,-545,60
1/28/2011,Consumer Staples,1128,-221,-300,607
1/28/2011,Energy,679,-157,-290,232
1/28/2011,Financials,1459,-389,-619,451
1/28/2011,Health Care,768,-325,-381,62
1/28/2011,Industrials,1028,-387,-453,188
1/28/2011,Information Technology,1140,-495,-551,94
1/28/2011,Materials,301,-277,-207,-183
1/28/2011,Telecommunication Services,318,-52,-69,197
1/28/2011,Utilities,378,-203,-234,-59
1/31/2011,Consumer Discretionary,1249,-398,-596,255
1/31/2011,Consumer Staples,1209,-198,-330,681
1/31/2011,Energy,775,-152,-323,300
1/31/2011,Financials,1642,-374,-659,609
1/31/2011,Health Care,863,-278,-388,197
1/31/2011,Industrials,1157,-344,-469,344
1/31/2011,Information Technology,1310,-431,-543,336
1/31/2011,Materials,352,-259,-209,-116
1/31/2011,Telecommunication Services,339,-40,-70,229
1/31/2011,Utilities,460,-176,-223,61
2/1/2011,Consumer Discretionary,1424,-361,-598,465
2/1/2011,Consumer Staples,1292,-201,-336,755
2/1/2011,Energy,848,-122,-315,411
2/1/2011,Financials,1820,-287,-633,900
2/1/2011,Health Care,962,-246,-384,332
2/1/2011,Industrials,1294,-289,-480,525
2/1/2011,Information Technology,1454,-388,-596,470
2/1/2011,Materials,422,-249,-223,-50
2/1/2011,Telecommunication Services,365,-29,-77,259
2/1/2011,Utilities,534,-130,-229,175
2/2/2011,Consumer Discretionary,1591,-323,-612,656
2/2/2011,Consumer Staples,1414,-167,-347,900
2/2/2011,Energy,949,-101,-326,522
2/2/2011,Financials,1959,-236,-648,1075
2/2/2011,Health Care,1060,-206,-410,444
2/2/2011,Industrials,1435,-254,-480,701
2/2/2011,Information Technology,1646,-315,-579,752
2/2/2011,Materials,486,-219,-235,32
2/2/2011,Telecommunication Services,390,-31,-92,267
2/2/2011,Utilities,600,-111,-234,255
2/3/2011,Consumer Discretionary,1781,-297,-608,876
2/3/2011,Consumer Staples,1545,-119,-370,1056
2/3/2011,Energy,1054,-94,-365,595
2/3/2011,Financials,2126,-209,-666,1251
2/3/2011,Health Care,1160,-158,-414,588
2/3/2011,Industrials,1581,-215,-497,869
2/3/2011,Information Technology,1836,-252,-581,1003
2/3/2011,Materials,570,-200,-254,116
2/3/2011,Telecommunication Services,419,-24,-95,300
2/3/2011,Utilities,673,-95,-229,349
2/4/2011,Consumer Discretionary,1986,-243,-632,1111
2/4/2011,Consumer Staples,1651,-72,-400,1179
2/4/2011,Energy,1153,-70,-370,713
2/4/2011,Financials,2303,-187,-673,1443
2/4/2011,Health Care,1311,-126,-432,753
2/4/2011,Industrials,1731,-162,-496,1073
2/4/2011,Information Technology,2008,-221,-615,1172
2/4/2011,Materials,649,-184,-255,210
2/4/2011,Telecommunication Services,457,-12,-113,332
2/4/2011,Utilities,740,-77,-238,425
2/7/2011,Consumer Discretionary,2194,-167,-645,1382
2/7/2011,Consumer Staples,1768,-37,-396,1335
2/7/2011,Energy,1247,-34,-369,844
2/7/2011,Financials,2496,-119,-715,1662
2/7/2011,Health Care,1403,-109,-430,864
2/7/2011,Industrials,1847,-136,-495,1216
2/7/2011,Information Technology,2156,-189,-636,1331
2/7/2011,Materials,712,-151,-243,318
2/7/2011,Telecommunication Services,492,2,-109,385
2/7/2011,Utilities,799,-73,-254,472
2/8/2011,Consumer Discretionary,2391,-139,-666,1586
2/8/2011,Consumer Staples,1881,-3,-393,1485
2/8/2011,Energy,1322,-9,-385,928
2/8/2011,Financials,2623,-59,-727,1837
2/8/2011,Health Care,1548,-102,-449,997
2/8/2011,Industrials,1994,-95,-511,1388
2/8/2011,Information Technology,2350,-105,-646,1599
2/8/2011,Materials,768,-144,-241,383
2/8/2011,Telecommunication Services,513,14,-112,415
2/8/2011,Utilities,881,-56,-257,568
2/9/2011,Consumer Discretionary,2554,-71,-649,1834
2/9/2011,Consumer Staples,1984,33,-412,1605
2/9/2011,Energy,1398,14,-402,1010
2/9/2011,Financials,2840,12,-760,2092
2/9/2011,Health Care,1631,-85,-466,1080
2/9/2011,Industrials,2160,-65,-524,1571
2/9/2011,Information Technology,2534,-66,-669,1799
2/9/2011,Materials,824,-147,-226,451
2/9/2011,Telecommunication Services,542,39,-105,476
2/9/2011,Utilities,966,-32,-264,670
2/10/2011,Consumer Discretionary,2680,-17,-688,1975
2/10/2011,Consumer Staples,2093,59,-420,1732
2/10/2011,Energy,1498,20,-383,1135
2/10/2011,Financials,3049,49,-777,2321
2/10/2011,Health Care,1763,-55,-456,1252
2/10/2011,Industrials,2295,-10,-535,1750
2/10/2011,Information Technology,2739,9,-709,2039
2/10/2011,Materials,874,-145,-249,480
2/10/2011,Telecommunication Services,570,38,-121,487
2/10/2011,Utilities,1044,-11,-290,743
2/11/2011,Consumer Discretionary,2794,61,-698,2157
2/11/2011,Consumer Staples,2183,93,-445,1831
2/11/2011,Energy,1587,31,-383,1235
2/11/2011,Financials,3219,101,-764,2556
2/11/2011,Health Care,1896,26,-504,1418
2/11/2011,Industrials,2419,19,-564,1874
2/11/2011,Information Technology,2881,44,-719,2206
2/11/2011,Materials,939,-118,-270,551
2/11/2011,Telecommunication Services,584,42,-108,518
2/11/2011,Utilities,1129,23,-300,852
2/14/2011,Consumer Discretionary,2944,114,-758,2300
2/14/2011,Consumer Staples,2245,127,-452,1920
2/14/2011,Energy,1687,53,-410,1330
2/14/2011,Financials,3437,172,-818,2791
2/14/2011,Health Care,2017,59,-495,1581
2/14/2011,Industrials,2562,93,-609,2046
2/14/2011,Information Technology,3021,78,-739,2360
2/14/2011,Materials,1025,-87,-276,662
2/14/2011,Telecommunication Services,596,56,-113,539
2/14/2011,Utilities,1196,32,-319,909
2/15/2011,Consumer Discretionary,3140,162,-787,2515
2/15/2011,Consumer Staples,2359,167,-457,2069
2/15/2011,Energy,1812,89,-432,1469
2/15/2011,Financials,3639,227,-855,3011
2/15/2011,Health Care,2143,101,-497,1747
2/15/2011,Industrials,2658,119,-611,2166
2/15/2011,Information Technology,3193,143,-776,2560
2/15/2011,Materials,1104,-47,-283,774
2/15/2011,Telecommunication Services,607,77,-129,555
2/15/2011,Utilities,1246,88,-313,1021
2/16/2011,Consumer Discretionary,3340,232,-824,2748
2/16/2011,Consumer Staples,2488,200,-471,2217
2/16/2011,Energy,1906,120,-430,1596
2/16/2011,Financials,3810,278,-888,3200
2/16/2011,Health Care,2287,128,-470,1945
2/16/2011,Industrials,2817,152,-627,2342
2/16/2011,Information Technology,3363,211,-788,2786
2/16/2011,Materials,1189,-17,-289,883
2/16/2011,Telecommunication Services,642,84,-135,591
2/16/2011,Utilities,1333,103,-351,1085
2/17/2011,Consumer Discretionary,3548,295,-841,3002
2/17/2011,Consumer Staples,2620,229,-471,2378
2/17/2011,Energy,2004,151,-466,1689
2/17/2011,Financials,4033,306,-875,3464
2/17/2011,Health Care,2393,157,-512,2038
2/17/2011,Industrials,2939,167,-620,2486
2/17/2011,Information Technology,3558,234,-816,2976
2/17/2011,Materials,1252,7,-290,969
2/17/2011,Telecommunication Services,664,88,-130,622
2/17/2011,Utilities,1412,137,-363,1186
2/18/2011,Consumer Discretionary,3711,326,-857,3180
2/18/2011,Consumer Staples,2712,274,-491,2495
2/18/2011,Energy,2088,176,-468,1796
2/18/2011,Financials,4239,397,-914,3722
2/18/2011,Health Care,2495,198,-524,2169
2/18/2011,Industrials,3065,202,-630,2637
2/18/2011,Information Technology,3728,328,-830,3226
2/18/2011,Materials,1316,43,-294,1065
2/18/2011,Telecommunication Services,693,99,-133,659
2/18/2011,Utilities,1488,176,-347,1317
2/21/2011,Consumer Discretionary,3904,352,-867,3389
2/21/2011,Consumer Staples,2826,332,-500,2658
2/21/2011,Energy,2156,202,-468,1890
2/21/2011,Financials,4397,490,-961,3926
2/21/2011,Health Care,2631,264,-520,2375
2/21/2011,Industrials,3213,239,-669,2783
2/21/2011,Information Technology,3923,398,-841,3480
2/21/2011,Materials,1395,81,-292,1184
2/21/2011,Telecommunication Services,723,100,-131,692
2/21/2011,Utilities,1561,205,-345,1421
2/22/2011,Consumer Discretionary,4130,432,-908,3654
2/22/2011,Consumer Staples,2948,361,-539,2770
2/22/2011,Energy,2275,216,-483,2008
2/22/2011,Financials,4615,519,-999,4135
2/22/2011,Health Care,2782,296,-567,2511
2/22/2011,Industrials,3357,319,-684,2992
2/22/2011,Information Technology,4102,451,-855,3698
2/22/2011,Materials,1457,90,-293,1254
2/22/2011,Telecommunication Services,749,111,-127,733
2/22/2011,Utilities,1663,236,-357,1542
2/23/2011,Consumer Discretionary,4281,503,-903,3881
2/23/2011,Consumer Staples,3084,358,-538,2904
2/23/2011,Energy,2358,243,-499,2102
2/23/2011,Financials,4784,576,-1055,4305
2/23/2011,Health Care,2887,318,-578,2627
2/23/2011,Industrials,3486,376,-737,3125
2/23/2011,Information Technology,4281,492,-891,3882
2/23/2011,Materials,1527,115,-306,1336
2/23/2011,Telecommunication Services,785,113,-133,765
2/23/2011,Utilities,1732,248,-363,1617
2/24/2011,Consumer Discretionary,4457,566,-892,4131
2/24/2011,Consumer Staples,3214,400,-535,3079
2/24/2011,Energy,2478,306,-518,2266
2/24/2011,Financials,4999,600,-1038,4561
2/24/2011,Health Care,3025,359,-596,2788
2/24/2011,Industrials,3668,410,-735,3343
2/24/2011,Information Technology,4481,573,-940,4114
2/24/2011,Materials,1556,167,-312,1411
2/24/2011,Telecommunication Services,814,128,-144,798
2/24/2011,Utilities,1833,272,-361,1744
2/25/2011,Consumer Discretionary,4657,632,-917,4372
2/25/2011,Consumer Staples,3328,433,-559,3202
2/25/2011,Energy,2570,334,-546,2358
2/25/2011,Financials,5186,666,-1067,4785
2/25/2011,Health Care,3152,416,-594,2974
2/25/2011,Industrials,3801,444,-763,3482
2/25/2011,Information Technology,4658,576,-968,4266
2/25/2011,Materials,1633,187,-317,1503
2/25/2011,Telecommunication Services,835,133,-144,824
2/25/2011,Utilities,1913,288,-371,1830
2/28/2011,Consumer Discretionary,4903,701,-969,4635
2/28/2011,Consumer Staples,3450,488,-589,3349
2/28/2011,Energy,2669,342,-557,2454
2/28/2011,Financials,5427,745,-1107,5065
2/28/2011,Health Care,3301,461,-616,3146
2/28/2011,Industrials,3999,459,-773,3685
2/28/2011,Information Technology,4858,630,-945,4543
2/28/2011,Materials,1687,187,-329,1545
2/28/2011,Telecommunication Services,866,155,-136,885
2/28/2011,Utilities,1977,324,-395,1906
3/1/2011,Consumer Discretionary,5084,765,-963,4886
3/1/2011,Consumer Staples,3606,504,-613,3497
3/1/2011,Energy,2782,387,-568,2601
3/1/2011,Financials,5608,817,-1140,5285
3/1/2011,Health Care,3421,484,-643,3262
3/1/2011,Industrials,4136,507,-780,3863
3/1/2011,Information Technology,5065,673,-920,4818
3/1/2011,Materials,1752,181,-381,1552
3/1/2011,Telecommunication Services,895,172,-135,932
3/1/2011,Utilities,2073,352,-422,2003
3/2/2011,Consumer Discretionary,5290,818,-1009,5099
3/2/2011,Consumer Staples,3707,554,-610,3651
3/2/2011,Energy,2902,443,-572,2773
3/2/2011,Financials,5803,885,-1135,5553
3/2/2011,Health Care,3536,523,-658,3401
3/2/2011,Industrials,4293,525,-783,4035
3/2/2011,Information Technology,5251,710,-961,5000
3/2/2011,Materials,1826,221,-379,1668
3/2/2011,Telecommunication Services,923,177,-132,968
3/2/2011,Utilities,2149,389,-415,2123
3/3/2011,Consumer Discretionary,5496,886,-1018,5364
3/3/2011,Consumer Staples,3838,584,-642,3780
3/3/2011,Energy,3003,488,-572,2919
3/3/2011,Financials,6005,957,-1159,5803
3/3/2011,Health Care,3657,568,-702,3523
3/3/2011,Industrials,4478,600,-807,4271
3/3/2011,Information Technology,5466,742,-983,5225
3/3/2011,Materials,1905,228,-391,1742
3/3/2011,Telecommunication Services,951,182,-135,998
3/3/2011,Utilities,2246,428,-415,2259
3/4/2011,Consumer Discretionary,5686,949,-1080,5555
3/4/2011,Consumer Staples,3948,617,-691,3874
3/4/2011,Energy,3110,495,-582,3023
3/4/2011,Financials,6230,1009,-1166,6073
3/4/2011,Health Care,3780,612,-701,3691
3/4/2011,Industrials,4632,656,-855,4433
3/4/2011,Information Technology,5705,827,-999,5533
3/4/2011,Materials,1953,255,-415,1793
3/4/2011,Telecommunication Services,976,196,-144,1028
3/4/2011,Utilities,2353,455,-415,2393
3/7/2011,Consumer Discretionary,5870,991,-1107,5754
3/7/2011,Consumer Staples,4063,670,-681,4052
3/7/2011,Energy,3210,521,-600,3131
3/7/2011,Financials,6435,1111,-1219,6327
3/7/2011,Health Care,3920,654,-717,3857
3/7/2011,Industrials,4804,713,-862,4655
3/7/2011,Information Technology,5878,894,-996,5776
3/7/2011,Materials,2032,256,-413,1875
3/7/2011,Telecommunication Services,1005,206,-146,1065
3/7/2011,Utilities,2414,455,-454,2415
3/8/2011,Consumer Discretionary,6096,1051,-1097,6050
3/8/2011,Consumer Staples,4188,702,-689,4201
3/8/2011,Energy,3340,555,-554,3341
3/8/2011,Financials,6632,1151,-1233,6550
3/8/2011,Health Care,4070,684,-731,4023
3/8/2011,Industrials,4905,741,-886,4760
3/8/2011,Information Technology,6050,938,-1018,5970
3/8/2011,Materials,2110,272,-421,1961
3/8/2011,Telecommunication Services,1041,199,-158,1082
3/8/2011,Utilities,2470,489,-472,2487
3/9/2011,Consumer Discretionary,6266,1120,-1107,6279
3/9/2011,Consumer Staples,4325,744,-704,4365
3/9/2011,Energy,3449,585,-574,3460
3/9/2011,Financials,6845,1208,-1233,6820
3/9/2011,Health Care,4194,741,-765,4170
3/9/2011,Industrials,5070,785,-920,4935
3/9/2011,Information Technology,6224,993,-1038,6179
3/9/2011,Materials,2173,296,-441,2028
3/9/2011,Telecommunication Services,1067,203,-159,1111
3/9/2011,Utilities,2563,524,-473,2614
3/10/2011,Consumer Discretionary,6461,1160,-1163,6458
3/10/2011,Consumer Staples,4451,752,-723,4480
3/10/2011,Energy,3553,624,-594,3583
3/10/2011,Financials,7007,1291,-1264,7034
3/10/2011,Health Care,4319,787,-780,4326
3/10/2011,Industrials,5224,823,-936,5111
3/10/2011,Information Technology,6389,1073,-1098,6364
3/10/2011,Materials,2251,313,-439,2125
3/10/2011,Telecommunication Services,1101,203,-158,1146
3/10/2011,Utilities,2657,540,-450,2747
3/11/2011,Consumer Discretionary,6665,1207,-1138,6734
3/11/2011,Consumer Staples,4589,828,-737,4680
3/11/2011,Energy,3668,662,-627,3703
3/11/2011,Financials,7210,1391,-1259,7342
3/11/2011,Health Care,4460,800,-799,4461
3/11/2011,Industrials,5385,836,-961,5260
3/11/2011,Information Technology,6572,1136,-1114,6594
3/11/2011,Materials,2332,322,-434,2220
3/11/2011,Telecommunication Services,1138,204,-171,1171
3/11/2011,Utilities,2730,559,-451,2838
3/14/2011,Consumer Discretionary,5100,1387,-1216,5271
3/14/2011,Consumer Staples,3721,545,-696,3570
3/14/2011,Energy,3086,487,-652,2921
3/14/2011,Financials,6580,1766,-1300,7046
3/14/2011,Health Care,4029,956,-889,4096
3/14/2011,Industrials,5392,760,-783,5369
3/14/2011,Information Technology,6040,1229,-1069,6200
3/14/2011,Materials,2355,136,-475,2016
3/14/2011,Telecommunication Services,993,209,-117,1085
3/14/2011,Utilities,2196,539,-427,2308
3/15/2011,Consumer Discretionary,5613,1459,-1236,5836
3/15/2011,Consumer Staples,4022,625,-695,3952
3/15/2011,Energy,3332,564,-681,3215
3/15/2011,Financials,6979,1765,-1329,7415
3/15/2011,Health Care,4271,942,-892,4321
3/15/2011,Industrials,5575,847,-804,5618
3/15/2011,Information Technology,6394,1270,-1136,6528
3/15/2011,Materials,2420,207,-480,2147
3/15/2011,Telecommunication Services,1059,223,-136,1146
3/15/2011,Utilities,2391,576,-451,2516
3/16/2011,Consumer Discretionary,6109,1501,-1278,6332
3/16/2011,Consumer Staples,4280,695,-719,4256
3/16/2011,Energy,3529,642,-699,3472
3/16/2011,Financials,7287,1747,-1375,7659
3/16/2011,Health Care,4487,965,-908,4544
3/16/2011,Industrials,5793,897,-831,5859
3/16/2011,Information Technology,6694,1338,-1143,6889
3/16/2011,Materials,2515,260,-498,2277
3/16/2011,Telecommunication Services,1101,231,-157,1175
3/16/2011,Utilities,2597,608,-482,2723
3/17/2011,Consumer Discretionary,6543,1584,-1311,6816
3/17/2011,Consumer Staples,4523,774,-718,4579
3/17/2011,Energy,3740,696,-692,3744
3/17/2011,Financials,7611,1780,-1411,7980
3/17/2011,Health Care,4667,994,-890,4771
3/17/2011,Industrials,5945,985,-867,6063
3/17/2011,Information Technology,6986,1414,-1170,7230
3/17/2011,Materials,2594,304,-494,2404
3/17/2011,Telecommunication Services,1150,233,-157,1226
3/17/2011,Utilities,2748,635,-492,2891
3/18/2011,Consumer Discretionary,6881,1634,-1346,7169
3/18/2011,Consumer Staples,4759,856,-736,4879
3/18/2011,Energy,3925,745,-693,3977
3/18/2011,Financials,7877,1796,-1443,8230
3/18/2011,Health Care,4824,1003,-887,4940
3/18/2011,Industrials,6102,1027,-936,6193
3/18/2011,Information Technology,7253,1455,-1201,7507
3/18/2011,Materials,2646,363,-487,2522
3/18/2011,Telecommunication Services,1191,244,-159,1276
3/18/2011,Utilities,2885,637,-513,3009
3/21/2011,Consumer Discretionary,7220,1667,-1346,7541
3/21/2011,Consumer Staples,4956,897,-763,5090
3/21/2011,Energy,4089,799,-687,4201
3/21/2011,Financials,8141,1866,-1465,8542
3/21/2011,Health Care,5017,1067,-879,5205
3/21/2011,Industrials,6251,1061,-982,6330
3/21/2011,Information Technology,7490,1507,-1254,7743
3/21/2011,Materials,2715,387,-497,2605
3/21/2011,Telecommunication Services,1232,264,-170,1326
3/21/2011,Utilities,3016,657,-512,3161
3/22/2011,Consumer Discretionary,7488,1699,-1363,7824
3/22/2011,Consumer Staples,5156,955,-794,5317
3/22/2011,Energy,4214,833,-702,4345
3/22/2011,Financials,8387,1903,-1472,8818
3/22/2011,Health Care,5143,1095,-899,5339
3/22/2011,Industrials,6407,1098,-1013,6492
3/22/2011,Information Technology,7704,1538,-1316,7926
3/22/2011,Materials,2808,408,-500,2716
3/22/2011,Telecommunication Services,1278,264,-171,1371
3/22/2011,Utilities,3147,684,-545,3286
3/23/2011,Consumer Discretionary,7813,1727,-1373,8167
3/23/2011,Consumer Staples,5288,1010,-810,5488
3/23/2011,Energy,4335,894,-704,4525
3/23/2011,Financials,8647,1956,-1497,9106
3/23/2011,Health Care,5307,1164,-922,5549
3/23/2011,Industrials,6574,1167,-1039,6702
3/23/2011,Information Technology,7880,1557,-1315,8122
3/23/2011,Materials,2895,447,-512,2830
3/23/2011,Telecommunication Services,1314,267,-178,1403
3/23/2011,Utilities,3246,740,-548,3438
3/24/2011,Consumer Discretionary,8042,1801,-1371,8472
3/24/2011,Consumer Staples,5438,1033,-820,5651
3/24/2011,Energy,4473,935,-722,4686
3/24/2011,Financials,8857,2018,-1521,9354
3/24/2011,Health Care,5473,1193,-943,5723
3/24/2011,Industrials,6702,1214,-1061,6855
3/24/2011,Information Technology,8105,1622,-1332,8395
3/24/2011,Materials,2989,485,-531,2943
3/24/2011,Telecommunication Services,1342,274,-186,1430
3/24/2011,Utilities,3334,769,-555,3548
3/25/2011,Consumer Discretionary,8278,1885,-1411,8752
3/25/2011,Consumer Staples,5588,1066,-841,5813
3/25/2011,Energy,4602,927,-726,4803
3/25/2011,Financials,9044,2064,-1548,9560
3/25/2011,Health Care,5621,1214,-982,5853
3/25/2011,Industrials,6839,1255,-1052,7042
3/25/2011,Information Technology,8304,1696,-1359,8641
3/25/2011,Materials,3041,525,-522,3044
3/25/2011,Telecommunication Services,1370,273,-192,1451
3/25/2011,Utilities,3437,793,-584,3646
3/28/2011,Consumer Discretionary,8491,1945,-1423,9013
3/28/2011,Consumer Staples,5735,1113,-866,5982
3/28/2011,Energy,4701,970,-746,4925
3/28/2011,Financials,9269,2077,-1564,9782
3/28/2011,Health Care,5766,1217,-1000,5983
3/28/2011,Industrials,6971,1325,-1063,7233
3/28/2011,Information Technology,8496,1765,-1357,8904
3/28/2011,Materials,3105,553,-527,3131
3/28/2011,Telecommunication Services,1406,289,-196,1499
3/28/2011,Utilities,3524,833,-584,3773
3/29/2011,Consumer Discretionary,8714,1975,-1454,9235
3/29/2011,Consumer Staples,5873,1141,-861,6153
3/29/2011,Energy,4790,1015,-752,5053
3/29/2011,Financials,9500,2143,-1600,10043
3/29/2011,Health Care,5872,1247,-996,6123
3/29/2011,Industrials,7118,1344,-1098,7364
3/29/2011,Information Technology,8714,1858,-1392,9180
3/29/2011,Materials,3155,548,-543,3160
3/29/2011,Telecommunication Services,1439,294,-211,1522
3/29/2011,Utilities,3606,848,-579,3875
3/30/2011,Consumer Discretionary,8935,2037,-1487,9485
3/30/2011,Consumer Staples,5969,1180,-881,6268
3/30/2011,Energy,4872,1063,-769,5166
3/30/2011,Financials,9715,2201,-1595,10321
3/30/2011,Health Care,6020,1285,-1009,6296
3/30/2011,Industrials,7256,1368,-1103,7521
3/30/2011,Information Technology,8886,1871,-1434,9323
3/30/2011,Materials,3211,574,-564,3221
3/30/2011,Telecommunication Services,1473,294,-204,1563
3/30/2011,Utilities,3691,877,-582,3986
3/31/2011,Consumer Discretionary,9131,2105,-1485,9751
3/31/2011,Consumer Staples,6094,1244,-881,6457
3/31/2011,Energy,4986,1103,-784,5305
3/31/2011,Financials,9924,2217,-1633,10508
3/31/2011,Health Care,6104,1331,-1014,6421
3/31/2011,Industrials,7400,1440,-1127,7713
3/31/2011,Information Technology,9093,1910,-1465,9538
3/31/2011,Materials,3272,605,-558,3319
3/31/2011,Telecommunication Services,1501,299,-213,1587
3/31/2011,Utilities,3759,907,-595,4071
4/1/2011,Consumer Discretionary,9293,2174,-1506,9961
4/1/2011,Consumer Staples,6218,1261,-895,6584
4/1/2011,Energy,5071,1138,-809,5400
4/1/2011,Financials,10076,2267,-1632,10711
4/1/2011,Health Care,6219,1382,-1040,6561
4/1/2011,Industrials,7545,1498,-1149,7894
4/1/2011,Information Technology,9246,1991,-1492,9745
4/1/2011,Materials,3365,646,-559,3452
4/1/2011,Telecommunication Services,1520,316,-223,1613
4/1/2011,Utilities,3857,918,-600,4175
4/4/2011,Consumer Discretionary,9454,2222,-1546,10130
4/4/2011,Consumer Staples,6316,1286,-875,6727
4/4/2011,Energy,5185,1175,-809,5551
4/4/2011,Financials,10270,2327,-1634,10963
4/4/2011,Health Care,6332,1433,-1042,6723
4/4/2011,Industrials,7680,1522,-1168,8034
4/4/2011,Information Technology,9451,2038,-1502,9987
4/4/2011,Materials,3431,674,-577,3528
4/4/2011,Telecommunication Services,1561,332,-227,1666
4/4/2011,Utilities,3927,970,-599,4298
4/5/2011,Consumer Discretionary,9663,2261,-1565,10359
4/5/2011,Consumer Staples,6459,1324,-913,6870
4/5/2011,Energy,5249,1212,-864,5597
4/5/2011,Financials,10471,2374,-1651,11194
4/5/2011,Health Care,6438,1453,-1063,6828
4/5/2011,Industrials,7796,1561,-1213,8144
4/5/2011,Information Technology,9596,2076,-1507,10165
4/5/2011,Materials,3473,710,-579,3604
4/5/2011,Telecommunication Services,1583,339,-228,1694
4/5/2011,Utilities,4008,968,-624,4352
4/6/2011,Consumer Discretionary,9827,2320,-1600,10547
4/6/2011,Consumer Staples,6572,1339,-968,6943
4/6/2011,Energy,5324,1220,-855,5689
4/6/2011,Financials,10678,2409,-1682,11405
4/6/2011,Health Care,6531,1467,-1079,6919
4/6/2011,Industrials,7939,1582,-1195,8326
4/6/2011,Information Technology,9755,2113,-1545,10323
4/6/2011,Materials,3536,712,-588,3660
4/6/2011,Telecommunication Services,1596,358,-226,1728
4/6/2011,Utilities,4075,981,-622,4434
4/7/2011,Consumer Discretionary,9999,2347,-1610,10736
4/7/2011,Consumer Staples,6642,1395,-981,7056
4/7/2011,Energy,5396,1262,-859,5799
4/7/2011,Financials,10861,2469,-1720,11610
4/7/2011,Health Care,6652,1495,-1079,7068
4/7/2011,Industrials,8055,1622,-1203,8474
4/7/2011,Information Technology,9925,2167,-1591,10501
4/7/2011,Materials,3602,716,-571,3747
4/7/2011,Telecommunication Services,1625,368,-228,1765
4/7/2011,Utilities,4133,997,-629,4501
4/8/2011,Consumer Discretionary,10172,2410,-1622,10960
4/8/2011,Consumer Staples,6734,1420,-1006,7148
4/8/2011,Energy,5482,1271,-853,5900
4/8/2011,Financials,11039,2537,-1787,11789
4/8/2011,Health Care,6760,1522,-1098,7184
4/8/2011,Industrials,8193,1651,-1235,8609
4/8/2011,Information Technology,10079,2198,-1586,10691
4/8/2011,Materials,3654,720,-590,3784
4/8/2011,Telecommunication Services,1651,373,-228,1796
4/8/2011,Utilities,4222,1029,-645,4606
4/11/2011,Consumer Discretionary,10343,2447,-1649,11141
4/11/2011,Consumer Staples,6848,1449,-1023,7274
4/11/2011,Energy,5567,1311,-875,6003
4/11/2011,Financials,11189,2583,-1768,12004
4/11/2011,Health Care,6843,1569,-1097,7315
4/11/2011,Industrials,8348,1675,-1275,8748
4/11/2011,Information Technology,10239,2231,-1585,10885
4/11/2011,Materials,3724,713,-598,3839
4/11/2011,Telecommunication Services,1689,377,-241,1825
4/11/2011,Utilities,4284,1061,-645,4700
4/12/2011,Consumer Discretionary,10469,2481,-1676,11274
4/12/2011,Consumer Staples,6931,1508,-1034,7405
4/12/2011,Energy,5651,1351,-874,6128
4/12/2011,Financials,11323,2648,-1795,12176
4/12/2011,Health Care,6944,1601,-1092,7453
4/12/2011,Industrials,8455,1713,-1278,8890
4/12/2011,Information Technology,10377,2289,-1613,11053
4/12/2011,Materials,3767,758,-611,3914
4/12/2011,Telecommunication Services,1725,380,-230,1875
4/12/2011,Utilities,4353,1075,-656,4772
4/13/2011,Consumer Discretionary,10615,2494,-1713,11396
4/13/2011,Consumer Staples,7023,1544,-1047,7520
4/13/2011,Energy,5732,1348,-898,6182
4/13/2011,Financials,11439,2683,-1798,12324
4/13/2011,Health Care,7052,1653,-1078,7627
4/13/2011,Industrials,8584,1786,-1310,9060
4/13/2011,Information Technology,10556,2350,-1634,11272
4/13/2011,Materials,3830,769,-613,3986
4/13/2011,Telecommunication Services,1737,385,-229,1893
4/13/2011,Utilities,4410,1074,-678,4806
4/14/2011,Consumer Discretionary,10774,2545,-1729,11590
4/14/2011,Consumer Staples,7116,1554,-1046,7624
4/14/2011,Energy,5803,1369,-918,6254
4/14/2011,Financials,11608,2683,-1819,12472
4/14/2011,Health Care,7134,1695,-1102,7727
4/14/2011,Industrials,8662,1813,-1314,9161
4/14/2011,Information Technology,10690,2383,-1667,11406
4/14/2011,Materials,3885,788,-616,4057
4/14/2011,Telecommunication Services,1763,403,-237,1929
4/14/2011,Utilities,4475,1106,-703,4878
4/15/2011,Consumer Discretionary,10933,2572,-1748,11757
4/15/2011,Consumer Staples,7215,1579,-1074,7720
4/15/2011,Energy,5884,1401,-914,6371
4/15/2011,Financials,11726,2750,-1879,12597
4/15/2011,Health Care,7271,1684,-1125,7830
4/15/2011,Industrials,8770,1841,-1312,9299
4/15/2011,Information Technology,10821,2422,-1708,11535
4/15/2011,Materials,3937,822,-619,4140
4/15/2011,Telecommunication Services,1779,413,-237,1955
4/15/2011,Utilities,4542,1132,-721,4953
4/18/2011,Consumer Discretionary,11072,2606,-1750,11928
4/18/2011,Consumer Staples,7309,1609,-1064,7854
4/18/2011,Energy,5964,1429,-924,6469
4/18/2011,Financials,11844,2798,-1866,12776
4/18/2011,Health Care,7343,1723,-1141,7925
4/18/2011,Industrials,8872,1850,-1331,9391
4/18/2011,Information Technology,10943,2468,-1737,11674
4/18/2011,Materials,3979,832,-638,4173
4/18/2011,Telecommunication Services,1799,409,-245,1963
4/18/2011,Utilities,4589,1175,-722,5042
4/19/2011,Consumer Discretionary,11283,2648,-1754,12177
4/19/2011,Consumer Staples,7386,1636,-1100,7922
4/19/2011,Energy,6038,1425,-941,6522
4/19/2011,Financials,12003,2827,-1922,12908
4/19/2011,Health Care,7456,1735,-1180,8011
4/19/2011,Industrials,9002,1853,-1337,9518
4/19/2011,Information Technology,11077,2502,-1751,11828
4/19/2011,Materials,4017,844,-635,4226
4/19/2011,Telecommunication Services,1825,407,-263,1969
4/19/2011,Utilities,4674,1204,-727,5151
4/20/2011,Consumer Discretionary,11445,2684,-1770,12359
4/20/2011,Consumer Staples,7456,1672,-1096,8032
4/20/2011,Energy,6118,1449,-960,6607
4/20/2011,Financials,12140,2863,-1901,13102
4/20/2011,Health Care,7544,1759,-1180,8123
4/20/2011,Industrials,9096,1848,-1367,9577
4/20/2011,Information Technology,11253,2565,-1752,12066
4/20/2011,Materials,4081,843,-662,4262
4/20/2011,Telecommunication Services,1847,427,-273,2001
4/20/2011,Utilities,4717,1180,-706,5191
4/21/2011,Consumer Discretionary,11568,2717,-1766,12519
4/21/2011,Consumer Staples,7553,1699,-1098,8154
4/21/2011,Energy,6179,1456,-981,6654
4/21/2011,Financials,12275,2959,-1923,13311
4/21/2011,Health Care,7629,1810,-1173,8266
4/21/2011,Industrials,9208,1892,-1388,9712
4/21/2011,Information Technology,11343,2599,-1755,12187
4/21/2011,Materials,4105,879,-684,4300
4/21/2011,Telecommunication Services,1870,429,-276,2023
4/21/2011,Utilities,4775,1179,-720,5234
4/22/2011,Consumer Discretionary,11676,2766,-1754,12688
4/22/2011,Consumer Staples,7648,1693,-1125,8216
4/22/2011,Energy,6239,1489,-976,6752
4/22/2011,Financials,12441,3007,-1932,13516
4/22/2011,Health Care,7733,1852,-1202,8383
4/22/2011,Industrials,9335,1951,-1406,9880
4/22/2011,Information Technology,11469,2624,-1756,12337
4/22/2011,Materials,4149,894,-687,4356
4/22/2011,Telecommunication Services,1884,427,-277,2034
4/22/2011,Utilities,4812,1197,-705,5304
4/25/2011,Consumer Discretionary,11773,2820,-1810,12783
4/25/2011,Consumer Staples,7712,1734,-1142,8304
4/25/2011,Energy,6343,1513,-981,6875
4/25/2011,Financials,12571,3047,-1958,13660
4/25/2011,Health Care,7826,1882,-1200,8508
4/25/2011,Industrials,9422,1996,-1457,9961
4/25/2011,Information Technology,11606,2702,-1739,12569
4/25/2011,Materials,4192,900,-695,4397
4/25/2011,Telecommunication Services,1905,435,-278,2062
4/25/2011,Utilities,4878,1217,-723,5372
4/26/2011,Consumer Discretionary,11885,2889,-1837,12937
4/26/2011,Consumer Staples,7809,1729,-1155,8383
4/26/2011,Energy,6387,1563,-988,6962
4/26/2011,Financials,12695,3067,-1980,13782
4/26/2011,Health Care,7876,1907,-1202,8581
4/26/2011,Industrials,9510,2041,-1494,10057
4/26/2011,Information Technology,11713,2755,-1768,12700
4/26/2011,Materials,4262,919,-694,4487
4/26/2011,Telecommunication Services,1931,438,-273,2096
4/26/2011,Utilities,4942,1225,-740,5427
4/27/2011,Consumer Discretionary,12024,2958,-1845,13137
4/27/2011,Consumer Staples,7871,1735,-1176,8430
4/27/2011,Energy,6444,1583,-982,7045
4/27/2011,Financials,12796,3075,-2012,13859
4/27/2011,Health Care,7959,1911,-1240,8630
4/27/2011,Industrials,9623,2077,-1473,10227
4/27/2011,Information Technology,11836,2756,-1797,12795
4/27/2011,Materials,4313,935,-716,4532
4/27/2011,Telecommunication Services,1938,444,-278,2104
4/27/2011,Utilities,5014,1225,-742,5497
4/28/2011,Consumer Discretionary,12134,2965,-1843,13256
4/28/2011,Consumer Staples,7921,1745,-1153,8513
4/28/2011,Energy,6484,1605,-986,7103
4/28/2011,Financials,12943,3115,-2042,14016
4/28/2011,Health Care,8045,1938,-1232,8751
4/28/2011,Industrials,9724,2108,-1487,10345
4/28/2011,Information Technology,11964,2783,-1822,12925
4/28/2011,Materials,4359,948,-714,4593
4/28/2011,Telecommunication Services,1952,447,-286,2113
4/28/2011,Utilities,5055,1236,-765,5526
4/29/2011,Consumer Discretionary,12223,2954,-1859,13318
4/29/2011,Consumer Staples,7991,1772,-1173,8590
4/29/2011,Energy,6556,1605,-981,7180
4/29/2011,Financials,13020,3176,-2001,14195
4/29/2011,Health Care,8123,1978,-1228,8873
4/29/2011,Industrials,9777,2142,-1480,10439
4/29/2011,Information Technology,12079,2800,-1812,13067
4/29/2011,Materials,4420,966,-690,4696
4/29/2011,Telecommunication Services,1969,456,-287,2138
4/29/2011,Utilities,5136,1261,-770,5627
5/2/2011,Consumer Discretionary,12396,3005,-1850,13551
5/2/2011,Consumer Staples,8061,1792,-1168,8685
5/2/2011,Energy,6652,1634,-995,7291
5/2/2011,Financials,13159,3237,-2000,14396
5/2/2011,Health Care,8195,1976,-1242,8929
5/2/2011,Industrials,9837,2180,-1458,10559
5/2/2011,Information Technology,12179,2840,-1829,13190
5/2/2011,Materials,4477,974,-683,4768
5/2/2011,Telecommunication Services,1981,448,-292,2137
5/2/2011,Utilities,5137,1309,-759,5687
5/3/2011,Consumer Discretionary,12504,3079,-1844,13739
5/3/2011,Consumer Staples,8137,1837,-1186,8788
5/3/2011,Energy,6693,1655,-1005,7343
5/3/2011,Financials,13254,3240,-2017,14477
5/3/2011,Health Care,8287,2025,-1253,9059
5/3/2011,Industrials,9929,2194,-1509,10614
5/3/2011,Information Technology,12273,2867,-1825,13315
5/3/2011,Materials,4493,967,-691,4769
5/3/2011,Telecommunication Services,1995,454,-294,2155
5/3/2011,Utilities,5160,1339,-768,5731
5/4/2011,Consumer Discretionary,12593,3122,-1863,13852
5/4/2011,Consumer Staples,8209,1849,-1176,8882
5/4/2011,Energy,6742,1656,-1020,7378
5/4/2011,Financials,13354,3265,-2007,14612
5/4/2011,Health Care,8327,2048,-1270,9105
5/4/2011,Industrials,9998,2229,-1540,10687
5/4/2011,Information Technology,12383,2878,-1844,13417
5/4/2011,Materials,4536,999,-713,4822
5/4/2011,Telecommunication Services,2001,450,-294,2157
5/4/2011,Utilities,5210,1338,-762,5786
5/5/2011,Consumer Discretionary,12660,3170,-1901,13929
5/5/2011,Consumer Staples,8263,1871,-1178,8956
5/5/2011,Energy,6767,1651,-1027,7391
5/5/2011,Financials,13486,3307,-2011,14782
5/5/2011,Health Care,8359,2074,-1271,9162
5/5/2011,Industrials,10108,2261,-1512,10857
5/5/2011,Information Technology,12504,2899,-1859,13544
5/5/2011,Materials,4562,1010,-704,4868
5/5/2011,Telecommunication Services,2018,457,-294,2181
5/5/2011,Utilities,5247,1347,-768,5826
5/6/2011,Consumer Discretionary,12746,3192,-1887,14051
5/6/2011,Consumer Staples,8313,1885,-1217,8981
5/6/2011,Energy,6795,1676,-1050,7421
5/6/2011,Financials,13632,3351,-2052,14931
5/6/2011,Health Care,8416,2097,-1262,9251
5/6/2011,Industrials,10193,2270,-1518,10945
5/6/2011,Information Technology,12608,2938,-1903,13643
5/6/2011,Materials,4612,1005,-709,4908
5/6/2011,Telecommunication Services,2030,467,-290,2207
5/6/2011,Utilities,5287,1369,-754,5902
5/9/2011,Consumer Discretionary,12829,3206,-1884,14151
5/9/2011,Consumer Staples,8384,1902,-1215,9071
5/9/2011,Energy,6879,1695,-1077,7497
5/9/2011,Financials,13737,3394,-2086,15045
5/9/2011,Health Care,8482,2104,-1260,9326
5/9/2011,Industrials,10275,2259,-1556,10978
5/9/2011,Information Technology,12673,2992,-1900,13765
5/9/2011,Materials,4660,985,-721,4924
5/9/2011,Telecommunication Services,2053,456,-302,2207
5/9/2011,Utilities,5333,1378,-764,5947
5/10/2011,Consumer Discretionary,12946,3185,-1894,14237
5/10/2011,Consumer Staples,8440,1899,-1194,9145
5/10/2011,Energy,6931,1704,-1063,7572
5/10/2011,Financials,13834,3425,-2075,15184
5/10/2011,Health Care,8541,2149,-1284,9406
5/10/2011,Industrials,10333,2282,-1536,11079
5/10/2011,Information Technology,12757,3035,-1912,13880
5/10/2011,Materials,4688,1001,-722,4967
5/10/2011,Telecommunication Services,2065,460,-306,2219
5/10/2011,Utilities,5374,1384,-769,5989
5/11/2011,Consumer Discretionary,13002,3226,-1911,14317
5/11/2011,Consumer Staples,8512,1884,-1199,9197
5/11/2011,Energy,6985,1714,-1061,7638
5/11/2011,Financials,13912,3442,-2097,15257
5/11/2011,Health Care,8614,2148,-1289,9473
5/11/2011,Industrials,10398,2294,-1535,11157
5/11/2011,Information Technology,12786,3050,-1931,13905
5/11/2011,Materials,4734,1015,-720,5029
5/11/2011,Telecommunication Services,2080,480,-304,2256
5/11/2011,Utilities,5409,1406,-788,6027
5/12/2011,Consumer Discretionary,13078,3248,-1956,14370
5/12/2011,Consumer Staples,8545,1900,-1214,9231
5/12/2011,Energy,7020,1733,-1045,7708
5/12/2011,Financials,13986,3452,-2145,15293
5/12/2011,Health Care,8687,2156,-1287,9556
5/12/2011,Industrials,10480,2330,-1522,11288
5/12/2011,Information Technology,12896,3112,-1900,14108
5/12/2011,Materials,4760,1032,-718,5074
5/12/2011,Telecommunication Services,2094,486,-311,2269
5/12/2011,Utilities,5475,1434,-777,6132
5/13/2011,Consumer Discretionary,13133,3298,-2007,14424
5/13/2011,Consumer Staples,8592,1935,-1214,9313
5/13/2011,Energy,7075,1729,-1034,7770
5/13/2011,Financials,14116,3505,-2145,15476
5/13/2011,Health Care,8732,2156,-1296,9592
5/13/2011,Industrials,10547,2324,-1545,11326
5/13/2011,Information Technology,12973,3155,-1920,14208
5/13/2011,Materials,4767,1029,-723,5073
5/13/2011,Telecommunication Services,2116,492,-312,2296
5/13/2011,Utilities,5513,1437,-786,6164
5/16/2011,Consumer Discretionary,13215,3319,-1992,14542
5/16/2011,Consumer Staples,8675,1932,-1215,9392
5/16/2011,Energy,7104,1759,-1018,7845
5/16/2011,Financials,14189,3495,-2172,15512
5/16/2011,Health Care,8786,2163,-1306,9643
5/16/2011,Industrials,10611,2323,-1543,11391
5/16/2011,Information Technology,13081,3183,-1959,14305
5/16/2011,Materials,4782,1052,-715,5119
5/16/2011,Telecommunication Services,2127,507,-297,2337
5/16/2011,Utilities,5548,1469,-789,6228
5/17/2011,Consumer Discretionary,13289,3346,-1972,14663
5/17/2011,Consumer Staples,8734,1960,-1218,9476
5/17/2011,Energy,7138,1787,-1038,7887
5/17/2011,Financials,14273,3528,-2218,15583
5/17/2011,Health Care,8840,2199,-1332,9707
5/17/2011,Industrials,10672,2366,-1539,11499
5/17/2011,Information Technology,13163,3179,-1993,14349
5/17/2011,Materials,4817,1095,-721,5191
5/17/2011,Telecommunication Services,2145,516,-294,2367
5/17/2011,Utilities,5575,1479,-800,6254
5/18/2011,Consumer Discretionary,13383,3374,-1988,14769
5/18/2011,Consumer Staples,8774,1980,-1245,9509
5/18/2011,Energy,7200,1769,-1026,7943
5/18/2011,Financials,14356,3556,-2227,15685
5/18/2011,Health Care,8895,2224,-1356,9763
5/18/2011,Industrials,10763,2357,-1565,11555
5/18/2011,Information Technology,13253,3186,-2014,14425
5/18/2011,Materials,4840,1110,-753,5197
5/18/2011,Telecommunication Services,2157,507,-302,2362
5/18/2011,Utilities,5593,1470,-807,6256
5/19/2011,Consumer Discretionary,13465,3400,-2003,14862
5/19/2011,Consumer Staples,8791,1991,-1229,9553
5/19/2011,Energy,7261,1791,-1062,7990
5/19/2011,Financials,14438,3603,-2209,15832
5/19/2011,Health Care,8933,2247,-1328,9852
5/19/2011,Industrials,10841,2392,-1551,11682
5/19/2011,Information Technology,13325,3184,-2047,14462
5/19/2011,Materials,4864,1096,-731,5229
5/19/2011,Telecommunication Services,2166,502,-297,2371
5/19/2011,Utilities,5608,1468,-787,6289
5/20/2011,Consumer Discretionary,13557,3457,-2010,15004
5/20/2011,Consumer Staples,8856,2028,-1259,9625
5/20/2011,Energy,7305,1778,-1060,8023
5/20/2011,Financials,14514,3650,-2223,15941
5/20/2011,Health Care,8965,2225,-1343,9847
5/20/2011,Industrials,10887,2418,-1543,11762
5/20/2011,Information Technology,13399,3183,-2056,14526
5/20/2011,Materials,4885,1089,-725,5249
5/20/2011,Telecommunication Services,2172,516,-304,2384
5/20/2011,Utilities,5629,1501,-795,6335
5/23/2011,Consumer Discretionary,6399,676,-1210,5865
5/23/2011,Consumer Staples,4638,394,-763,4269
5/23/2011,Energy,3087,421,-692,2816
5/23/2011,Financials,7408,1718,-1155,7971
5/23/2011,Health Care,2774,871,-865,2780
5/23/2011,Industrials,5480,675,-891,5264
5/23/2011,Information Technology,5837,863,-1351,5349
5/23/2011,Materials,1641,340,-427,1554
5/23/2011,Telecommunication Services,1318,116,-152,1282
5/23/2011,Utilities,3119,562,-404,3277
5/24/2011,Consumer Discretionary,7893,1230,-1377,7746
5/24/2011,Consumer Staples,5547,737,-871,5413
5/24/2011,Energy,3967,686,-768,3885
5/24/2011,Financials,8901,2130,-1375,9656
5/24/2011,Health Care,4067,1181,-961,4287
5/24/2011,Industrials,6616,1052,-1029,6639
5/24/2011,Information Technology,7416,1372,-1483,7305
5/24/2011,Materials,2326,514,-509,2331
5/24/2011,Telecommunication Services,1504,195,-185,1514
5/24/2011,Utilities,3666,775,-496,3945
5/25/2011,Consumer Discretionary,9081,1704,-1537,9248
5/25/2011,Consumer Staples,6249,1016,-926,6339
5/25/2011,Energy,4682,932,-819,4795
5/25/2011,Financials,10134,2446,-1562,11018
5/25/2011,Health Care,5141,1398,-1049,5490
5/25/2011,Industrials,7534,1356,-1148,7742
5/25/2011,Information Technology,8715,1773,-1604,8884
5/25/2011,Materials,2857,667,-538,2986
5/25/2011,Telecommunication Services,1641,251,-205,1687
5/25/2011,Utilities,4085,916,-547,4454
5/26/2011,Consumer Discretionary,10087,2066,-1651,10502
5/26/2011,Consumer Staples,6842,1238,-1010,7070
5/26/2011,Energy,5246,1104,-851,5499
5/26/2011,Financials,11105,2714,-1747,12072
5/26/2011,Health Care,5993,1603,-1135,6461
5/26/2011,Industrials,8300,1574,-1240,8634
5/26/2011,Information Technology,9771,2104,-1735,10140
5/26/2011,Materials,3315,778,-563,3530
5/26/2011,Telecommunication Services,1758,314,-234,1838
5/26/2011,Utilities,4438,1048,-615,4871
5/27/2011,Consumer Discretionary,10882,2371,-1758,11495
5/27/2011,Consumer Staples,7302,1409,-1065,7646
5/27/2011,Energy,5708,1277,-901,6084
5/27/2011,Financials,11920,2944,-1879,12985
5/27/2011,Health Care,6704,1720,-1190,7234
5/27/2011,Industrials,8914,1792,-1329,9377
5/27/2011,Information Technology,10618,2355,-1808,11165
5/27/2011,Materials,3690,853,-593,3950
5/27/2011,Telecommunication Services,1858,364,-254,1968
5/27/2011,Utilities,4727,1131,-666,5192
5/30/2011,Consumer Discretionary,11580,2621,-1820,12381
5/30/2011,Consumer Staples,7695,1555,-1143,8107
5/30/2011,Energy,6081,1413,-935,6559
5/30/2011,Financials,12555,3141,-1985,13711
5/30/2011,Health Care,7253,1849,-1237,7865
5/30/2011,Industrials,9433,1953,-1401,9985
5/30/2011,Information Technology,11255,2570,-1848,11977
5/30/2011,Materials,3979,900,-642,4237
5/30/2011,Telecommunication Services,1923,398,-264,2057
5/30/2011,Utilities,4956,1246,-723,5479
5/31/2011,Consumer Discretionary,12076,2776,-1902,12950
5/31/2011,Consumer Staples,8033,1689,-1188,8534
5/31/2011,Energy,6409,1511,-969,6951
5/31/2011,Financials,13102,3271,-2041,14332
5/31/2011,Health Care,7714,1956,-1245,8425
5/31/2011,Industrials,9841,2078,-1405,10514
5/31/2011,Information Technology,11833,2740,-1874,12699
5/31/2011,Materials,4206,952,-675,4483
5/31/2011,Telecommunication Services,1984,408,-272,2120
5/31/2011,Utilities,5158,1316,-741,5733
6/1/2011,Consumer Discretionary,12519,2963,-1956,13526
6/1/2011,Consumer Staples,8314,1782,-1205,8891
6/1/2011,Energy,6666,1566,-991,7241
6/1/2011,Financials,13514,3377,-2107,14784
6/1/2011,Health Care,8064,2058,-1254,8868
6/1/2011,Industrials,10146,2163,-1426,10883
6/1/2011,Information Technology,12301,2844,-1894,13251
6/1/2011,Materials,4404,995,-687,4712
6/1/2011,Telecommunication Services,2043,433,-265,2211
6/1/2011,Utilities,5292,1360,-767,5885
6/2/2011,Consumer Discretionary,12893,3074,-1996,13971
6/2/2011,Consumer Staples,8557,1883,-1238,9202
6/2/2011,Energy,6883,1642,-1042,7483
6/2/2011,Financials,13867,3477,-2103,15241
6/2/2011,Health Care,8363,2145,-1274,9234
6/2/2011,Industrials,10363,2238,-1465,11136
6/2/2011,Information Technology,12683,2954,-1901,13736
6/2/2011,Materials,4585,1051,-703,4933
6/2/2011,Telecommunication Services,2086,462,-281,2267
6/2/2011,Utilities,5410,1391,-785,6016
6/3/2011,Consumer Discretionary,13178,3178,-2009,14347
6/3/2011,Consumer Staples,8726,1927,-1282,9371
6/3/2011,Energy,7044,1711,-1053,7702
6/3/2011,Financials,14167,3547,-2155,15559
6/3/2011,Health Care,8642,2208,-1295,9555
6/3/2011,Industrials,10590,2331,-1502,11419
6/3/2011,Information Technology,12989,3029,-1936,14082
6/3/2011,Materials,4714,1083,-728,5069
6/3/2011,Telecommunication Services,2115,470,-285,2300
6/3/2011,Utilities,5516,1432,-800,6148
6/6/2011,Consumer Discretionary,13400,3257,-2055,14602
6/6/2011,Consumer Staples,8868,1986,-1285,9569
6/6/2011,Energy,7176,1751,-1065,7862
6/6/2011,Financials,14472,3594,-2208,15858
6/6/2011,Health Care,8860,2258,-1331,9787
6/6/2011,Industrials,10771,2360,-1540,11591
6/6/2011,Information Technology,13221,3122,-1988,14355
6/6/2011,Materials,4823,1109,-738,5194
6/6/2011,Telecommunication Services,2152,490,-299,2343
6/6/2011,Utilities,5602,1451,-835,6218
6/7/2011,Consumer Discretionary,13631,3306,-2024,14913
6/7/2011,Consumer Staples,8988,2044,-1298,9734
6/7/2011,Energy,7301,1802,-1083,8020
6/7/2011,Financials,14664,3658,-2238,16084
6/7/2011,Health Care,9009,2303,-1341,9971
6/7/2011,Industrials,10923,2420,-1573,11770
6/7/2011,Information Technology,13417,3218,-2047,14588
6/7/2011,Materials,4896,1125,-737,5284
6/7/2011,Telecommunication Services,2163,506,-310,2359
6/7/2011,Utilities,5691,1480,-831,6340
6/8/2011,Consumer Discretionary,13816,3381,-2061,15136
6/8/2011,Consumer Staples,9062,2092,-1295,9859
6/8/2011,Energy,7430,1834,-1095,8169
6/8/2011,Financials,14832,3698,-2247,16283
6/8/2011,Health Care,9146,2323,-1343,10126
6/8/2011,Industrials,11061,2441,-1587,11915
6/8/2011,Information Technology,13587,3283,-2079,14791
6/8/2011,Materials,4974,1154,-741,5387
6/8/2011,Telecommunication Services,2196,522,-309,2409
6/8/2011,Utilities,5743,1503,-849,6397
6/9/2011,Consumer Discretionary,13944,3440,-2076,15308
6/9/2011,Consumer Staples,9133,2107,-1294,9946
6/9/2011,Energy,7496,1855,-1080,8271
6/9/2011,Financials,14953,3793,-2230,16516
6/9/2011,Health Care,9269,2348,-1367,10250
6/9/2011,Industrials,11172,2482,-1607,12047
6/9/2011,Information Technology,13756,3325,-2108,14973
6/9/2011,Materials,5026,1166,-762,5430
6/9/2011,Telecommunication Services,2211,527,-320,2418
6/9/2011,Utilities,5802,1527,-859,6470
6/10/2011,Consumer Discretionary,14094,3495,-2124,15465
6/10/2011,Consumer Staples,9218,2127,-1302,10043
6/10/2011,Energy,7564,1878,-1055,8387
6/10/2011,Financials,15084,3850,-2250,16684
6/10/2011,Health Care,9376,2354,-1337,10393
6/10/2011,Industrials,11249,2484,-1629,12104
6/10/2011,Information Technology,13887,3359,-2138,15108
6/10/2011,Materials,5079,1184,-765,5498
6/10/2011,Telecommunication Services,2235,528,-334,2429
6/10/2011,Utilities,5850,1545,-861,6534
6/13/2011,Consumer Discretionary,14214,3543,-2132,15625
6/13/2011,Consumer Staples,9293,2155,-1293,10155
6/13/2011,Energy,7607,1905,-1083,8429
6/13/2011,Financials,15207,3844,-2267,16784
6/13/2011,Health Care,9487,2371,-1361,10497
6/13/2011,Industrials,11329,2547,-1639,12237
6/13/2011,Information Technology,13977,3400,-2127,15250
6/13/2011,Materials,5101,1185,-756,5530
6/13/2011,Telecommunication Services,2260,533,-326,2467
6/13/2011,Utilities,5885,1566,-832,6619
6/14/2011,Consumer Discretionary,14264,3600,-2171,15693
6/14/2011,Consumer Staples,9316,2155,-1302,10169
6/14/2011,Energy,7688,1887,-1103,8472
6/14/2011,Financials,15304,3870,-2258,16916
6/14/2011,Health Care,9554,2390,-1386,10558
6/14/2011,Industrials,11403,2568,-1672,12299
6/14/2011,Information Technology,14096,3451,-2127,15420
6/14/2011,Materials,5134,1209,-759,5584
6/14/2011,Telecommunication Services,2278,535,-322,2491
6/14/2011,Utilities,5917,1602,-831,6688
6/15/2011,Consumer Discretionary,14342,3595,-2178,15759
6/15/2011,Consumer Staples,9353,2179,-1316,10216
6/15/2011,Energy,7728,1867,-1125,8470
6/15/2011,Financials,15391,3877,-2278,16990
6/15/2011,Health Care,9616,2402,-1388,10630
6/15/2011,Industrials,11465,2616,-1657,12424
6/15/2011,Information Technology,14176,3434,-2118,15492
6/15/2011,Materials,5163,1215,-750,5628
6/15/2011,Telecommunication Services,2283,539,-314,2508
6/15/2011,Utilities,5948,1613,-836,6725
6/16/2011,Consumer Discretionary,14391,3611,-2191,15811
6/16/2011,Consumer Staples,9417,2186,-1312,10291
6/16/2011,Energy,7773,1880,-1155,8498
6/16/2011,Financials,15449,3914,-2346,17017
6/16/2011,Health Care,9653,2407,-1373,10687
6/16/2011,Industrials,11509,2627,-1639,12497
6/16/2011,Information Technology,14263,3468,-2114,15617
6/16/2011,Materials,5169,1208,-741,5636
6/16/2011,Telecommunication Services,2290,536,-308,2518
6/16/2011,Utilities,5982,1600,-820,6762
6/17/2011,Consumer Discretionary,14471,3656,-2207,15920
6/17/2011,Consumer Staples,9468,2197,-1292,10373
6/17/2011,Energy,7820,1884,-1148,8556
6/17/2011,Financials,15520,3895,-2349,17066
6/17/2011,Health Care,9709,2433,-1412,10730
6/17/2011,Industrials,11563,2661,-1659,12565
6/17/2011,Information Technology,14330,3487,-2120,15697
6/17/2011,Materials,5198,1212,-727,5683
6/17/2011,Telecommunication Services,2304,537,-303,2538
6/17/2011,Utilities,6010,1602,-828,6784
6/20/2011,Consumer Discretionary,14521,3691,-2216,15996
6/20/2011,Consumer Staples,9526,2192,-1320,10398
6/20/2011,Energy,7824,1925,-1148,8601
6/20/2011,Financials,15555,3900,-2325,17130
6/20/2011,Health Care,9755,2468,-1448,10775
6/20/2011,Industrials,11595,2680,-1666,12609
6/20/2011,Information Technology,14364,3495,-2124,15735
6/20/2011,Materials,5230,1197,-741,5686
6/20/2011,Telecommunication Services,2314,539,-306,2547
6/20/2011,Utilities,6051,1592,-835,6808
6/21/2011,Consumer Discretionary,14563,3696,-2212,16047
6/21/2011,Consumer Staples,9558,2226,-1326,10458
6/21/2011,Energy,7872,1968,-1160,8680
6/21/2011,Financials,15590,3932,-2373,17149
6/21/2011,Health Care,9801,2470,-1459,10812
6/21/2011,Industrials,11621,2667,-1698,12590
6/21/2011,Information Technology,14414,3512,-2153,15773
6/21/2011,Materials,5246,1213,-720,5739
6/21/2011,Telecommunication Services,2324,529,-298,2555
6/21/2011,Utilities,6073,1592,-828,6837
6/22/2011,Consumer Discretionary,14646,3683,-2205,16124
6/22/2011,Consumer Staples,9585,2235,-1303,10517
6/22/2011,Energy,7899,1976,-1146,8729
6/22/2011,Financials,15660,3964,-2369,17255
6/22/2011,Health Care,9825,2486,-1410,10901
6/22/2011,Industrials,11685,2696,-1677,12704
6/22/2011,Information Technology,14441,3542,-2138,15845
6/22/2011,Materials,5277,1210,-746,5741
6/22/2011,Telecommunication Services,2329,533,-309,2553
6/22/2011,Utilities,6080,1603,-850,6833
6/23/2011,Consumer Discretionary,14654,3704,-2217,16141
6/23/2011,Consumer Staples,9599,2236,-1295,10540
6/23/2011,Energy,7922,1988,-1129,8781
6/23/2011,Financials,15717,3944,-2382,17279
6/23/2011,Health Care,9823,2493,-1404,10912
6/23/2011,Industrials,11719,2692,-1676,12735
6/23/2011,Information Technology,14530,3562,-2134,15958
6/23/2011,Materials,5292,1190,-739,5743
6/23/2011,Telecommunication Services,2351,541,-311,2581
6/23/2011,Utilities,6115,1633,-869,6879
6/24/2011,Consumer Discretionary,14713,3708,-2164,16257
6/24/2011,Consumer Staples,9658,2260,-1300,10618
6/24/2011,Energy,7924,1963,-1130,8757
6/24/2011,Financials,15733,3943,-2363,17313
6/24/2011,Health Care,9859,2511,-1408,10962
6/24/2011,Industrials,11752,2719,-1686,12785
6/24/2011,Information Technology,14571,3577,-2106,16042
6/24/2011,Materials,5316,1206,-755,5767
6/24/2011,Telecommunication Services,2363,548,-321,2590
6/24/2011,Utilities,6119,1638,-861,6896
6/27/2011,Consumer Discretionary,14749,3746,-2143,16352
6/27/2011,Consumer Staples,9678,2256,-1329,10605
6/27/2011,Energy,7958,1987,-1126,8819
6/27/2011,Financials,15780,3976,-2384,17372
6/27/2011,Health Care,9886,2512,-1401,10997
6/27/2011,Industrials,11761,2720,-1699,12782
6/27/2011,Information Technology,14596,3574,-2121,16049
6/27/2011,Materials,5338,1210,-744,5804
6/27/2011,Telecommunication Services,2351,550,-330,2571
6/27/2011,Utilities,6124,1622,-857,6889
6/28/2011,Consumer Discretionary,14777,3765,-2187,16355
6/28/2011,Consumer Staples,9692,2254,-1321,10625
6/28/2011,Energy,7975,1988,-1128,8835
6/28/2011,Financials,15817,4016,-2390,17443
6/28/2011,Health Care,9864,2513,-1419,10958
6/28/2011,Industrials,11776,2675,-1702,12749
6/28/2011,Information Technology,14660,3577,-2148,16089
6/28/2011,Materials,5384,1217,-748,5853
6/28/2011,Telecommunication Services,2360,561,-336,2585
6/28/2011,Utilities,6150,1624,-866,6908
6/29/2011,Consumer Discretionary,14827,3791,-2232,16386
6/29/2011,Consumer Staples,9705,2269,-1341,10633
6/29/2011,Energy,7998,1989,-1124,8863
6/29/2011,Financials,15829,3994,-2386,17437
6/29/2011,Health Care,9889,2501,-1446,10944
6/29/2011,Industrials,11825,2692,-1694,12823
6/29/2011,Information Technology,14655,3614,-2188,16081
6/29/2011,Materials,5393,1224,-754,5863
6/29/2011,Telecommunication Services,2366,561,-343,2584
6/29/2011,Utilities,6160,1658,-882,6936
6/30/2011,Consumer Discretionary,14879,3814,-2249,16444
6/30/2011,Consumer Staples,9724,2261,-1342,10643
6/30/2011,Energy,8022,2020,-1147,8895
6/30/2011,Financials,15888,4009,-2410,17487
6/30/2011,Health Care,9887,2510,-1453,10944
6/30/2011,Industrials,11854,2711,-1698,12867
6/30/2011,Information Technology,14708,3592,-2180,16120
6/30/2011,Materials,5400,1227,-766,5861
6/30/2011,Telecommunication Services,2384,561,-326,2619
6/30/2011,Utilities,6165,1645,-896,6914
7/1/2011,Consumer Discretionary,14886,3816,-2250,16452
7/1/2011,Consumer Staples,9736,2272,-1329,10679
7/1/2011,Energy,8035,2040,-1153,8922
7/1/2011,Financials,15901,4041,-2380,17562
7/1/2011,Health Care,9910,2516,-1478,10948
7/1/2011,Industrials,11865,2711,-1708,12868
7/1/2011,Information Technology,14726,3621,-2167,16180
7/1/2011,Materials,5424,1234,-759,5899
7/1/2011,Telecommunication Services,2378,544,-343,2579
7/1/2011,Utilities,6186,1676,-889,6973
7/4/2011,Consumer Discretionary,14888,3817,-2238,16467
7/4/2011,Consumer Staples,9730,2277,-1338,10669
7/4/2011,Energy,8056,2042,-1132,8966
7/4/2011,Financials,15918,4052,-2379,17591
7/4/2011,Health Care,9950,2499,-1507,10942
7/4/2011,Industrials,11902,2715,-1691,12926
7/4/2011,Information Technology,14784,3626,-2176,16234
7/4/2011,Materials,5401,1216,-759,5858
7/4/2011,Telecommunication Services,2384,551,-340,2595
7/4/2011,Utilities,6206,1681,-866,7021
7/5/2011,Consumer Discretionary,14933,3846,-2230,16549
7/5/2011,Consumer Staples,9727,2283,-1366,10644
7/5/2011,Energy,8049,2047,-1153,8943
7/5/2011,Financials,15947,4075,-2362,17660
7/5/2011,Health Care,9965,2507,-1501,10971
7/5/2011,Industrials,11934,2720,-1690,12964
7/5/2011,Information Technology,14797,3641,-2168,16270
7/5/2011,Materials,5418,1233,-774,5877
7/5/2011,Telecommunication Services,2395,555,-335,2615
7/5/2011,Utilities,6223,1671,-871,7023
7/6/2011,Consumer Discretionary,14973,3872,-2172,16673
7/6/2011,Consumer Staples,9733,2299,-1362,10670
7/6/2011,Energy,8055,2063,-1143,8975
7/6/2011,Financials,15964,4093,-2382,17675
7/6/2011,Health Care,9982,2515,-1503,10994
7/6/2011,Industrials,11936,2723,-1686,12973
7/6/2011,Information Technology,14825,3637,-2177,16285
7/6/2011,Materials,5438,1238,-778,5898
7/6/2011,Telecommunication Services,2394,546,-348,2592
7/6/2011,Utilities,6231,1674,-872,7033
7/7/2011,Consumer Discretionary,15001,3868,-2169,16700
7/7/2011,Consumer Staples,9754,2343,-1352,10745
7/7/2011,Energy,8083,2074,-1137,9020
7/7/2011,Financials,15998,4066,-2421,17643
7/7/2011,Health Care,9999,2494,-1471,11022
7/7/2011,Industrials,11965,2751,-1687,13029
7/7/2011,Information Technology,14836,3649,-2138,16347
7/7/2011,Materials,5450,1237,-814,5873
7/7/2011,Telecommunication Services,2403,546,-336,2613
7/7/2011,Utilities,6256,1654,-891,7019
7/8/2011,Consumer Discretionary,15031,3882,-2165,16748
7/8/2011,Consumer Staples,9783,2331,-1376,10738
7/8/2011,Energy,8090,2082,-1132,9040
7/8/2011,Financials,15996,4073,-2415,17654
7/8/2011,Health Care,10016,2493,-1468,11041
7/8/2011,Industrials,11953,2792,-1710,13035
7/8/2011,Information Technology,14843,3676,-2140,16379
7/8/2011,Materials,5433,1260,-812,5881
7/8/2011,Telecommunication Services,2397,551,-329,2619
7/8/2011,Utilities,6269,1656,-885,7040
7/11/2011,Consumer Discretionary,15047,3869,-2184,16732
7/11/2011,Consumer Staples,9818,2304,-1366,10756
7/11/2011,Energy,8082,2050,-1164,8968
7/11/2011,Financials,16022,4063,-2447,17638
7/11/2011,Health Care,10033,2501,-1480,11054
7/11/2011,Industrials,12003,2806,-1723,13086
7/11/2011,Information Technology,14834,3626,-2169,16291
7/11/2011,Materials,5415,1254,-817,5852
7/11/2011,Telecommunication Services,2397,554,-325,2626
7/11/2011,Utilities,6289,1644,-868,7065
7/12/2011,Consumer Discretionary,15092,3865,-2139,16818
7/12/2011,Consumer Staples,9821,2269,-1361,10729
7/12/2011,Energy,8082,2058,-1180,8960
7/12/2011,Financials,16089,4107,-2498,17698
7/12/2011,Health Care,10044,2526,-1492,11078
7/12/2011,Industrials,11998,2817,-1689,13126
7/12/2011,Information Technology,14848,3619,-2169,16298
7/12/2011,Materials,5421,1281,-834,5868
7/12/2011,Telecommunication Services,2406,562,-329,2639
7/12/2011,Utilities,6304,1660,-874,7090
7/13/2011,Consumer Discretionary,15113,3888,-2152,16849
7/13/2011,Consumer Staples,9836,2293,-1372,10757
7/13/2011,Energy,8106,2064,-1194,8976
7/13/2011,Financials,16111,4094,-2467,17738
7/13/2011,Health Care,10029,2562,-1497,11094
7/13/2011,Industrials,12025,2814,-1701,13138
7/13/2011,Information Technology,14911,3608,-2194,16325
7/13/2011,Materials,5443,1279,-808,5914
7/13/2011,Telecommunication Services,2406,568,-332,2642
7/13/2011,Utilities,6255,1658,-877,7036
7/14/2011,Consumer Discretionary,15130,3885,-2174,16841
7/14/2011,Consumer Staples,9878,2289,-1361,10806
7/14/2011,Energy,8118,2053,-1170,9001
7/14/2011,Financials,16138,4096,-2473,17761
7/14/2011,Health Care,10033,2557,-1464,11126
7/14/2011,Industrials,12051,2819,-1686,13184
7/14/2011,Information Technology,14960,3644,-2189,16415
7/14/2011,Materials,5472,1288,-796,5964
7/14/2011,Telecommunication Services,2401,558,-331,2628
7/14/2011,Utilities,6272,1686,-887,7071
7/15/2011,Consumer Discretionary,15139,3887,-2199,16827
7/15/2011,Consumer Staples,9861,2313,-1375,10799
7/15/2011,Energy,8117,2059,-1169,9007
7/15/2011,Financials,16170,4118,-2465,17823
7/15/2011,Health Care,10051,2533,-1451,11133
7/15/2011,Industrials,12032,2849,-1683,13198
7/15/2011,Information Technology,14961,3688,-2201,16448
7/15/2011,Materials,5479,1279,-792,5966
7/15/2011,Telecommunication Services,2397,540,-322,2615
7/15/2011,Utilities,6288,1687,-907,7068
7/18/2011,Consumer Discretionary,15131,3868,-2226,16773
7/18/2011,Consumer Staples,9869,2322,-1377,10814
7/18/2011,Energy,8127,2047,-1170,9004
7/18/2011,Financials,16165,4133,-2458,17840
7/18/2011,Health Care,10052,2534,-1462,11124
7/18/2011,Industrials,12050,2858,-1722,13186
7/18/2011,Information Technology,14986,3659,-2172,16473
7/18/2011,Materials,5477,1284,-772,5989
7/18/2011,Telecommunication Services,2400,544,-316,2628
7/18/2011,Utilities,6285,1697,-899,7083
7/19/2011,Consumer Discretionary,15141,3884,-2212,16813
7/19/2011,Consumer Staples,9876,2330,-1394,10812
7/19/2011,Energy,8142,2060,-1175,9027
7/19/2011,Financials,16172,4124,-2457,17839
7/19/2011,Health Care,10070,2553,-1487,11136
7/19/2011,Industrials,12050,2826,-1726,13150
7/19/2011,Information Technology,15008,3725,-2164,16569
7/19/2011,Materials,5471,1279,-791,5959
7/19/2011,Telecommunication Services,2396,544,-315,2625
7/19/2011,Utilities,6284,1706,-900,7090
7/20/2011,Consumer Discretionary,15183,3912,-2200,16895
7/20/2011,Consumer Staples,9879,2321,-1395,10805
7/20/2011,Energy,8163,2074,-1168,9069
7/20/2011,Financials,16167,4145,-2448,17864
7/20/2011,Health Care,10063,2534,-1459,11138
7/20/2011,Industrials,12095,2844,-1717,13222
7/20/2011,Information Technology,14993,3730,-2139,16584
7/20/2011,Materials,5486,1259,-777,5968
7/20/2011,Telecommunication Services,2384,550,-310,2624
7/20/2011,Utilities,6301,1708,-907,7102
7/21/2011,Consumer Discretionary,15207,3881,-2221,16867
7/21/2011,Consumer Staples,9855,2294,-1414,10735
7/21/2011,Energy,8168,2077,-1192,9053
7/21/2011,Financials,16176,4175,-2476,17875
7/21/2011,Health Care,10093,2544,-1481,11156
7/21/2011,Industrials,12126,2799,-1719,13206
7/21/2011,Information Technology,15020,3758,-2126,16652
7/21/2011,Materials,5513,1270,-777,6006
7/21/2011,Telecommunication Services,2390,561,-306,2645
7/21/2011,Utilities,6295,1707,-892,7110
7/22/2011,Consumer Discretionary,15213,3879,-2226,16866
7/22/2011,Consumer Staples,9857,2291,-1401,10747
7/22/2011,Energy,8162,2055,-1210,9007
7/22/2011,Financials,16182,4171,-2478,17875
7/22/2011,Health Care,10110,2541,-1468,11183
7/22/2011,Industrials,12112,2806,-1714,13204
7/22/2011,Information Technology,15036,3792,-2098,16730
7/22/2011,Materials,5515,1294,-779,6030
7/22/2011,Telecommunication Services,2384,544,-310,2618
7/22/2011,Utilities,6323,1705,-900,7128
7/25/2011,Consumer Discretionary,15229,3888,-2257,16860
7/25/2011,Consumer Staples,9872,2294,-1387,10779
7/25/2011,Energy,8174,2044,-1205,9013
7/25/2011,Financials,16214,4145,-2461,17898
7/25/2011,Health Care,10107,2572,-1455,11224
7/25/2011,Industrials,12151,2844,-1725,13270
7/25/2011,Information Technology,15043,3804,-2110,16737
7/25/2011,Materials,5508,1285,-772,6021
7/25/2011,Telecommunication Services,2386,555,-316,2625
7/25/2011,Utilities,6314,1711,-913,7112
7/26/2011,Consumer Discretionary,15272,3891,-2255,16908
7/26/2011,Consumer Staples,9889,2286,-1409,10766
7/26/2011,Energy,8179,2057,-1188,9048
7/26/2011,Financials,16220,4154,-2420,17954
7/26/2011,Health Care,10121,2581,-1511,11191
7/26/2011,Industrials,12154,2814,-1738,13230
7/26/2011,Information Technology,15057,3761,-2124,16694
7/26/2011,Materials,5505,1284,-793,5996
7/26/2011,Telecommunication Services,2397,557,-323,2631
7/26/2011,Utilities,6313,1725,-920,7118
7/27/2011,Consumer Discretionary,15257,3891,-2243,16905
7/27/2011,Consumer Staples,9903,2286,-1425,10764
7/27/2011,Energy,8167,2066,-1193,9040
7/27/2011,Financials,16222,4166,-2400,17988
7/27/2011,Health Care,10147,2621,-1512,11256
7/27/2011,Industrials,12151,2858,-1747,13262
7/27/2011,Information Technology,15101,3760,-2140,16721
7/27/2011,Materials,5530,1300,-813,6017
7/27/2011,Telecommunication Services,2406,564,-329,2641
7/27/2011,Utilities,6327,1728,-932,7123
7/28/2011,Consumer Discretionary,15276,3928,-2245,16959
7/28/2011,Consumer Staples,9891,2273,-1437,10727
7/28/2011,Energy,8196,2071,-1191,9076
7/28/2011,Financials,16256,4154,-2419,17991
7/28/2011,Health Care,10164,2658,-1511,11311
7/28/2011,Industrials,12145,2827,-1737,13235
7/28/2011,Information Technology,15094,3773,-2134,16733
7/28/2011,Materials,5512,1297,-818,5991
7/28/2011,Telecommunication Services,2415,556,-333,2638
7/28/2011,Utilities,6320,1723,-924,7119
7/29/2011,Consumer Discretionary,15271,3934,-2240,16965
7/29/2011,Consumer Staples,9898,2280,-1419,10759
7/29/2011,Energy,8200,2083,-1187,9096
7/29/2011,Financials,16307,4194,-2435,18066
7/29/2011,Health Care,10143,2644,-1503,11284
7/29/2011,Industrials,12187,2832,-1738,13281
7/29/2011,Information Technology,15127,3793,-2160,16760
7/29/2011,Materials,5528,1292,-800,6020
7/29/2011,Telecommunication Services,2413,552,-318,2647
7/29/2011,Utilities,6320,1723,-927,7116
8/1/2011,Consumer Discretionary,15290,3921,-2264,16947
8/1/2011,Consumer Staples,9909,2284,-1425,10768
8/1/2011,Energy,8214,2100,-1195,9119
8/1/2011,Financials,16283,4211,-2436,18058
8/1/2011,Health Care,10173,2603,-1523,11253
8/1/2011,Industrials,12159,2818,-1738,13239
8/1/2011,Information Technology,15132,3785,-2176,16741
8/1/2011,Materials,5501,1299,-785,6015
8/1/2011,Telecommunication Services,2408,549,-329,2628
8/1/2011,Utilities,6311,1715,-924,7102
8/2/2011,Consumer Discretionary,15283,3948,-2248,16983
8/2/2011,Consumer Staples,9933,2278,-1435,10776
8/2/2011,Energy,8201,2100,-1196,9105
8/2/2011,Financials,16299,4211,-2458,18052
8/2/2011,Health Care,10176,2616,-1519,11273
8/2/2011,Industrials,12153,2815,-1722,13246
8/2/2011,Information Technology,15147,3800,-2201,16746
8/2/2011,Materials,5520,1290,-794,6016
8/2/2011,Telecommunication Services,2417,555,-328,2644
8/2/2011,Utilities,6316,1718,-922,7112
8/3/2011,Consumer Discretionary,15311,3944,-2231,17024
8/3/2011,Consumer Staples,9944,2289,-1444,10789
8/3/2011,Energy,8193,2101,-1187,9107
8/3/2011,Financials,16312,4212,-2431,18093
8/3/2011,Health Care,10193,2621,-1530,11284
8/3/2011,Industrials,12163,2820,-1763,13220
8/3/2011,Information Technology,15146,3797,-2187,16756
8/3/2011,Materials,5519,1301,-812,6008
8/3/2011,Telecommunication Services,2418,560,-330,2648
8/3/2011,Utilities,6325,1698,-924,7099
8/4/2011,Consumer Discretionary,15350,3941,-2241,17050
8/4/2011,Consumer Staples,9952,2321,-1439,10834
8/4/2011,Energy,8202,2109,-1188,9123
8/4/2011,Financials,16305,4190,-2418,18077
8/4/2011,Health Care,10195,2630,-1511,11314
8/4/2011,Industrials,12158,2824,-1728,13254
8/4/2011,Information Technology,15145,3760,-2173,16732
8/4/2011,Materials,5523,1300,-811,6012
8/4/2011,Telecommunication Services,2428,562,-330,2660
8/4/2011,Utilities,6375,1692,-917,7150
8/5/2011,Consumer Discretionary,15350,3928,-2248,17030
8/5/2011,Consumer Staples,9933,2303,-1421,10815
8/5/2011,Energy,8194,2133,-1228,9099
8/5/2011,Financials,16305,4230,-2414,18121
8/5/2011,Health Care,10231,2617,-1497,11351
8/5/2011,Industrials,12181,2794,-1734,13241
8/5/2011,Information Technology,15144,3786,-2172,16758
8/5/2011,Materials,5518,1313,-798,6033
8/5/2011,Telecommunication Services,2425,570,-332,2663
8/5/2011,Utilities,6372,1696,-891,7177
8/8/2011,Consumer Discretionary,15352,3893,-2223,17022
8/8/2011,Consumer Staples,9943,2306,-1435,10814
8/8/2011,Energy,8220,2120,-1222,9118
8/8/2011,Financials,16306,4222,-2434,18094
8/8/2011,Health Care,10229,2594,-1497,11326
8/8/2011,Industrials,12197,2837,-1730,13304
8/8/2011,Information Technology,15177,3793,-2159,16811
8/8/2011,Materials,5511,1310,-807,6014
8/8/2011,Telecommunication Services,2433,562,-332,2663
8/8/2011,Utilities,6389,1693,-888,7194
8/9/2011,Consumer Discretionary,15291,3910,-2224,16977
8/9/2011,Consumer Staples,9961,2328,-1438,10851
8/9/2011,Energy,8215,2132,-1234,9113
8/9/2011,Financials,16334,4194,-2447,18081
8/9/2011,Health Care,10242,2579,-1510,11311
8/9/2011,Industrials,12232,2850,-1757,13325
8/9/2011,Information Technology,15169,3780,-2159,16790
8/9/2011,Materials,5513,1284,-819,5978
8/9/2011,Telecommunication Services,2432,564,-330,2666
8/9/2011,Utilities,6397,1688,-888,7197
8/10/2011,Consumer Discretionary,15338,3927,-2175,17090
8/10/2011,Consumer Staples,9982,2336,-1459,10859
8/10/2011,Energy,8227,2123,-1212,9138
8/10/2011,Financials,16362,4196,-2464,18094
8/10/2011,Health Care,10231,2572,-1494,11309
8/10/2011,Industrials,12247,2824,-1746,13325
8/10/2011,Information Technology,15165,3754,-2194,16725
8/10/2011,Materials,5527,1284,-817,5994
8/10/2011,Telecommunication Services,2425,567,-330,2662
8/10/2011,Utilities,6402,1707,-874,7235
8/11/2011,Consumer Discretionary,15373,3930,-2171,17132
8/11/2011,Consumer Staples,9969,2360,-1459,10870
8/11/2011,Energy,8212,2126,-1206,9132
8/11/2011,Financials,16372,4191,-2422,18141
8/11/2011,Health Care,10221,2581,-1502,11300
8/11/2011,Industrials,12266,2861,-1745,13382
8/11/2011,Information Technology,15184,3759,-2209,16734
8/11/2011,Materials,5513,1281,-820,5974
8/11/2011,Telecommunication Services,2423,568,-320,2671
8/11/2011,Utilities,6402,1721,-896,7227
8/12/2011,Consumer Discretionary,15390,3952,-2196,17146
8/12/2011,Consumer Staples,9962,2347,-1434,10875
8/12/2011,Energy,8221,2127,-1201,9147
8/12/2011,Financials,16374,4207,-2457,18124
8/12/2011,Health Care,10218,2602,-1511,11309
8/12/2011,Industrials,12280,2841,-1738,13383
8/12/2011,Information Technology,15187,3718,-2212,16693
8/12/2011,Materials,5529,1276,-819,5986
8/12/2011,Telecommunication Services,2431,577,-327,2681
8/12/2011,Utilities,6382,1736,-885,7233
8/15/2011,Consumer Discretionary,15393,3947,-2223,17117
8/15/2011,Consumer Staples,10000,2344,-1425,10919
8/15/2011,Energy,8224,2135,-1208,9151
8/15/2011,Financials,16369,4204,-2478,18095
8/15/2011,Health Care,10214,2584,-1521,11277
8/15/2011,Industrials,12258,2830,-1727,13361
8/15/2011,Information Technology,15182,3687,-2227,16642
8/15/2011,Materials,5549,1276,-831,5994
8/15/2011,Telecommunication Services,2433,568,-345,2656
8/15/2011,Utilities,6393,1713,-888,7218
